=========..=========
= .................=
=.================.=
=.=.=...====...=.=.=
=.=...=......=...=.=
=.================.=
