====================
=.=.=.=.=..=.=.=.=G=
=.=.=.=.=.==.=.=.=.=
=.=.=...=..=.=.=.=.=
=.=.=.=.=.==.=.=.=.=
....................
=.=*......G.....*=.=
=.=======..=======.=
=.......==.=.......=
=======.=..=.=======
........=.==........
=======.=..=.=======
=.=g..=......=g..=.=
=.=...=.====.=...=.=
....................
=.=...=.====.=...=.=
=.=*..=.=  =.=..*=.=
=.=====.====.=====.=
=.................C=
====================