====================
=                  =
= = ============ = =
= = =   ====   = = =
= =   =      =   = =
= ================ =
= =              = =
= =======  ======= =
=       == =       =
= ===== =  = ===== =
=        = ==      =
======= =  = ===== =
  =   =      =   = =
= =   = ==== =   = =
= =              = =
= =   = ==== =   = =
= =   = =  = =   = =
= ===== ==== ===== =
=                  =
====================
