====================
=                  =
= ===== =     ==== =
= = =   ====   = = =
=                  =
================== =
= .                =
====================